Acidianus_hospitalis	Archaea
Acidilobus_saccharos	Eukarya
Aciduliprofundum_bos	Archaea
Aeropyrum_pernix_K1s	Archaea
Arabidopsis_tha_AT1G72550_1s	Eukarya
Archaeoglobus_fulgids	Archaea
Bacillus_subtilis_16s	Bacteria
Bacteroides_thetaiota_BTs	Bacteria
Borrelia_burgdorferi_Bs	Bacteria
Ca_Nitrososphaera_gs	Archaea
Caldiarchaeum_subtes	Archaea
Caldivirga_maquilins	Archaea
Campylobacter_jejuni_s	Bacteria
Cenarchaeum_sys	Archaea
Chlamydia_trachomatis_Ds	Bacteria
Desulfurococcus_kams	Archaea
Dictyostelium_dis_DDBs	Eukarya
Entamoeba_histolytica_s	Eukarya
Escherichia_coli_K_12_ss	Bacteria
Ferroglobus_placidus	Archaea
Ferroplasma_acidarms	Archaea
Fervidicoccus_fontis	Archaea
Halalkalicoccus_jeos	Archaea
Haloarcula_marismorts	Archaea
Halobacterium_NRC_1s	Archaea
Haloferax_volcanii_s	Archaea
Homo_sapienss	Eukarya
Hyperthermus_butylis	Archaea
Ignicoccus_hospitals	Archaea
Ignisphaera_aggregas	Archaea
Leishmania_infant_LinJ19s	Eukarya
Metallosphaera_cuprs	Archaea
Metallosphaera_sedus	Archaea
Methanobacterium_ALs	Archaea
Methanocaldococcus_js	Archaea
Methanocella_paludis	Archaea
Methanococcus_marips	Archaea
Methanocorpusculum_s	Archaea
Methanoculleus_maris	Archaea
Methanohalobium_eves	Archaea
Methanoplanus_petros	Archaea
Methanosaeta_thermos	Archaea
Methanosarcina_acetis	Archaea
Methanosphaera_stadts	Archaea
Methanosphaerula_pas	Archaea
Methanospirillum_huns	Archaea
Methanothermobacters	Archaea
Methanothermus_fervs	Archaea
Methanotorris_igneus	Archaea
Nitrosoarchaeum_kors	Archaea
Nitrosoarchaeum_lims	Archaea
Nitrosopumilus_maris	Archaea
Picrophilus_torriduss	Archaea
Plasmodium_falcip_PF11_0051s	Eukarya
Pyrobaculum_aerophils	Archaea
Pyrobaculum_calidifs	Archaea
Pyrococcus_furiosus_s	Archaea
Pyrolobus_fumarii_1s	Archaea
Rhodopirellula_balticas	Bacteria
Rickettsia_prowazekii_Ms	Bacteria
Saccharomyces_cereviss	Eukarya
Staphylothermus_mars	Archaea
Sulfolobus_acidocalds	Archaea
Sulfolobus_islandics	Archaea
Sulfolobus_solfataris	Archaea
Sulfolobus_tokodaii_s	Archaea
Synechocystis_PCC_680s	Bacteria
Tetrahymena_ther_XPs	Eukarya
Thalassiosira_pseudos	Eukarya
Thermococcus_kodakars	Archaea
Thermofilum_pendenss	Archaea
Thermoplasma_acidophs	Archaea
Thermoproteus_uzonis	Archaea
Thermosphaera_aggres	Archaea
Thermotoga_maritima_MSs	Bacteria
Trichomonas_vaginaliss	Eukarya
Vulcanisaeta_distris	Archaea
Methanomassili_MlumB10_12s	Archaea
Candidatus_Thorarchaeota_archaeon_SMTZ1_83s	Archaea
Candidatus_Thorarchaeota_archaeon_SMTZ1_45s	Archaea
